*************************************************************************************************
*                                                                                               *
***********  *  *  *********************  *  ************* ********** ************** ************
*         *        *      *            *     *          *   *   *  *   *                        *
*   ***   *        *      *   *****    *  *  *   ****   *   * * *  *   ************   **** ******
*   ***   *  *  *         *   *****    *     *    **    * * *   *  *             **   ****      *
*   ***   *               *   *****    *     *    **    *   * * *  *******  *  * **   ****      *
*   ***   *        *      *   *****    *  *  *    **    *   *   *        *  *  * **   ******  * *
*         *  *  *  *      *            *          **    * * * * *  *  *  *  *  * **        *    *
*****   ***        ********            *     *    **    *   *   *  *  *  *  *  * ******    *    *
*                                      *  *  *    **    *   *   *  *  *  *  *  *           *  * *
***********************************    *     *    **    * * *   *  *  *  *  *  *  *******  *    *
*************   *******************       *  *    **    *   *   *  *  *  *  *  *  *******  *    *
***********   *   *****************    *  *  *    **    *   *   *  *  *  *  *  *           *  * *
********      *     ***************    *  *  *    **    * * *   *  *  *  *  ******** ***   **  **
******        *        ************    *  *  *    **    *   *   *  *  *  *                      *
*             *                        *  *  *   ****   *   *   *  ****  ** **************** ** *
** ********************************    *  *  *          *   *                                   *
*   *    *    *    *    *    *    *    *  *  ************* **************** * * * ********* * * *
*   *         *         *         *    *                                                        *
*   *    *    *    *    *    *    *    ******************* ********* * * * ******* * * * ********
*        *         *         *         *****************                ** **            ***    *
*   *    *    *    *    *    *    *    *****************        ******            *****         *
*************************************************************************************************
