***************************************************************************
*                     **********                    **********            *
*    ****************                                                  *  *
*                      *****************     *********                 *  *
*   ******  *                          *                          *       *
*           *       ***************    *               *************   *  *
*           *                   *                         *               *
*   ********        *                               *****   *          *  *
*              *      ***********************       *       *          *  *
*           *                       *                     *               *
*************                     ******************************       *  *
*               *************       *                 *       *           *
* *********                     ***********           *       *   *       *
*           *************                             *       *   *       *
*                   *********                                 *           *
*   *         **********                          ***************      *  *
*   *   ************                *              *             *        *
*   *   *       **********                         *   ****   ***         *
*       *                       *              *               *     **   *
*                           *******            *    ************      *   *
*   **********************************           *                        *
*                                                *        *               *
***************************************************************************
